Date,milestone,profile_group,numHosts,High,Medium,Low,Warning,Total,
22-09-20,,Microsoft-Servers,1,5,6,2,5,18,
22-09-20,1,Microsoft-Servers,16,46,96,13,109,264,
22-09-20,1,Network & Security Devices,108,186,310,83,267,846,
22-09-20,1,SAN-Switches & Routers,20,78,0,0,94,172,
22-09-20,2,BRANCHES-LEGACY-SERVERS-LINUX,103,12482,38678,7253,881,59294,
22-09-20,2,Network & Security Devices,12,19,21,4,17,61,
22-09-20,3,AIX-Servers,29,3003,5794,1053,288,10138,
22-09-20,3,Microsoft-Servers,111,690,3455,895,639,5679,
,,,400,16509,48360,9303,2300,76472,
30-11-20,,Microsoft-Servers,1,5,6,2,5,18,
30-11-20,1,BRANCHES-LEGACY-SERVERS-LINUX,19,348,1084,230,125,1787,
30-11-20,1,Microsoft-Servers,16,46,96,13,109,264,
30-11-20,1,Network & Security Devices,198,228,189,34,75,526,
30-11-20,1,SAN-Switches & Routers,20,78,0,0,94,172,
30-11-20,2,BRANCHES-LEGACY-SERVERS-LINUX,4,920,2672,472,40,4104,
30-11-20,2,Network & Security Devices,9,13,12,3,14,42,
30-11-20,3,AIX-Servers,37,3330,6196,1129,334,10989,-8%
30-11-20,3,BRANCHES-LEGACY-SERVERS-LINUX,84,3491,9221,2124,624,15460,New
30-11-20,3,Microsoft-Servers,111,690,3457,895,652,5694,0%
30-11-20,3,Network & Security Devices,3,4,0,0,2,6,New
,,,502,9153,22933,4902,2074,39062,49%
